00 00 00 00 00 00 00 00 00 00 00 00 00 00 00 01 00 00 00 00
01 01 00 00 00 00 00 00 00 00 00 00 00 00 00 00 00 00 01 01
01 25 00 00 00 00 00 00 05 01 01 05 00 00 00 00 00 00 01 01
01 01 00 00 00 00 00 00 01 01 01 01 00 00 00 00 00 00 21 01
01 27 00 00 00 00 00 00 09 01 01 07 00 00 00 00 00 00 01 01
01 01 00 00 00 00 00 00 01 01 01 01 00 00 00 00 00 00 24 01
01 28 00 00 00 00 00 00 08 01 01 08 00 00 00 00 00 00 01 01
01 01 00 00 00 00 00 00 00 00 00 00 00 00 00 00 00 00 19 01
01 14 00 00 00 00 00 00 00 00 00 00 00 00 00 00 00 00 01 01
01 01 00 00 00 00 00 00 00 00 00 00 00 00 00 00 00 00 29 01
01 17 00 00 00 00 01 04 04 01 01 04 04 01 00 00 00 00 01 01
01 01 00 00 00 00 01 01 01 01 01 01 01 01 00 00 00 00 10 01